bläser	bläser
strassen	strasse
roter	rot
rotes	rot
roten   rot
leine	leine
hundeleine	hundeleine
vase	vase
vasen	vase
strasse	strasse
straßen	strasse
straße	strasse
jacke	jacke
jacken	jacke
kameras	kamera
modern	modern
küche	kuche
messer	messer
küchen	kuche
kuchen	kuchen
modem	modem
decke	decke
leder	leder
buche	buche
sucher	sucher
extern	extern
kanne	kanne
sicherheits	sicherheit
sicherheit	sicherheit
kindle	kindl
wandern	wander
wander	wander
marke	marke
lauflern	lauflern
mars	mars
helene	helene
erotik	eroti
kösen	kosen
damen	dame
biker	biker
panem	panem
sims	sims
kitchen	kitchen
nike	nike
pizzen	pizza
weber	weber
wars	wars
laser	laser
becker	becker
innen	innen
base	base
dosen	dose
dose	dose
boden	boden
feder	feder
tasten	taste
taste	taste
kekse	keks
eisen	eisen
ratten	ratt
ratte	ratt
hase	hase
hasen	hase
marlene	marlene
thule	thule
einmal	einmal
löwe	löwe
leuchten	leucht
leuchte	leucht
socken	socke
drucker	drucker
wecker	wecker
mixer	mixer